11111111111111111111
1C1100000C0010001E11
1P011100010010101001
11000000000110100011
11111001111110111111
10C00001C01000111111
10000000001011111111
1C1100000C101C111011
10011100010010110011
110000000001101C0C01
11111001110010110001
10C00001C00000000111
11111111111111111111
