111111111111111111111111111111111
111111111111111111111111111111111
110C0100000P100000C100C0111111111
11C0000100100010C1000000000000E11
111111111111111111111111111111111
111111111111111111111111111111111
