111111111111111111111111111
11PC01100000000000C10C1E011
111101100111000000101001011
100101111100000000000100001
1000000000000000000C0000001
11111100000C000000000000001
1000000000000000C0000000001
1000000000C0000000000000001
100000000000000001000000001
111100011111111101111100001
1110000000000000010000C0111
110C0000100C000000000000011
11100000100000100110C000111
111111111111111111111111111
